wwwwwwwwwwwwwwwwwwwwwwwwwww
w        wg               w
w     wwwwwwwwwwwwwwwwwww w
w                       w w
w                       w w
w                       w w
w                       w w
w                       w w
w                       w w
w         s             w w
w                       w w
w                       w w
w                         w
w                         w
wwwwwwwwwwwwwwwwwwwwwwwwwww